S..###...#####
..###..#######
#..###.##....#
#..#....######
#....##..##.##
..##.#...#####
...#.###...###
#..#..##..####
##.##...#...##
...##..##.#.##
#..###.##.####
...##..##...##
...##.#####.##
...##..####..#
##.##...###G##
